..#####.....
..#...######
###C#x...x.#
#.C.xxx#.C.#
#P.Cx#CC...#
####....####
...######...