#########
####..x##
####.#.##
####.C.##
#...Cxx##
#PC.#####
#...#####
#########
