#######
#.P#..#
#C.x..#
#xC...#
#.....#
#######
