################
##...........###
##.#C#######CC.#
##xxxx...Cxxx..#
##.#.########..#
#.CC.....C..#..#
#..#.###...x#.##
#..#xxx#.##x#.##
####xxx#C.#.#C##
#...#.##.C#.#..#
#.C.#..#...x...#
#.CC#..###P.#..#
#.C...CC.####.##
#...#..#......##
################