########
##..####
#...C.##
#.x##P##
#####C##
####...#
####x..#
########