..####...
###..####
#.....C.#
#.#..#C.#
#.x.x#P.#
#########
